11111111111111111111
1E000100000000001001
10001000000000001001
10011011101010111001
10000000100000000001
10000001000000010011
10000000100000001001
10001000100000001001
10001000000001111001
11111000000001000001
10000000000001000001
11111111111111111111