NO ../textures/bluestone.xpm
SO ../textures/colorstone.xpm
WE ../textures/purplestone.xpm
EA ../textures/wood.xpm

C 0,191,255
F 97,144,0

1111111111111111111111111
1000000111110000000000001
1011000001110000010000001
1001001100000000000000001
1110001110110000011100001     1111111111
1000E00000110000011101001     1100010001
1000000000000000110101001     1010101001
1100000111010101111101101     1001000101
1100000111010101111101101     1111111111
1100000111010101111101101
1111111111111111111111111


1111111111111111111111111
1000000111110000000000001
1011000001110000010000001
1001001100000000000000001
1100000111010101111101101
1111111111111111111111111
