NO ../textures/eagle.xpm
SO ../textures/redbrick.xpm
WE ../textures/greystone.xpm
EA ../textures/bluestone.xpm
F 220,100,0
C 225,30,0

11111111111111
10000000000001
1S000000000001
11111111111111
