NO ../textures/eagle.xpm
SO ../textures/eagle.xpm
WE ../textures/eagle.xpm
EA ../textures/eagle.xpm
F 220,100,0
C 225,30,0

11111111111111
10000000000001
1N000000000001
11111111111111
