WE                    ../textures/colorstone.xpm
EA ../textures/redbrick.xpm


F   220     ,100      ,    0    
C     225 ,30 ,   0

NO ../textures/greystone.xpm
SO ../textures/bluestone.xpm


        11111111111111111111111111
        100000000011000000000000001
        101100000111000000W0000011
        1001000000000000000000001
111111111011000001110000000000001
100000000011000001110111111111111
11110111111111011100000010001
11110111111111011101010010001
11000000110101000000000010001
10000000000000000000000010001
10000000000000001101010010001
11111111111111111111111111111
11110111111111011100000010001
11110111111111011101010010001
11000000110101000000000010001
10000000000000000000000010001
10000000000000001101010010001
11111111111111111111111111111
11110111111111011100000010001
11110111111111011101010010001
11000000110101000000000010001
10000000000000000000000010001
10000000000000001101010010001
11111111111111111111111111111
11110111111111011101010010001
11000000110101000000000010001
10000000000000000000000010001
10000000000000001101010010001
11111111111111111111111111111
