NO ../textures/eagle.xpm
SO ../textures/eagle.xpm
WE ../textures/eagle.xpm
EA ../textures/eagle.xpm
F 50,50,50
C 100,100,100

111111
100001
1000N1
100001
111111
