NO textures/eagle.xpm
SO textures/redbrick.xpm
WE textures/greystone.xpm
EA textures/bluestone.xpm
F 220,100,0
C 225,30,0

111111111111111111111111111111111111111111
1N0001000000000010010101000100000000001001
100010000000000010000010000000000010011001
100110111010101110000110111010101110011111
100000001000000000000000001000000000000101
100001000000000010010101000100000000001001
100010000000000010000010000000000010011001
100110111010101110000110111010101110011111
100000001000000000000000001000000000000101
100001000000000010010101000100000000001001
100010000000000010000010000000000010011001
100110111010101110000110111010101110011111
100000001000000000000000001000000000000101
100001000000000010010101000100000000001001
100010000000000010000010000000000010011001
100110111010101110000110111010101110011111
100000001000000000000000001000000000000101
100001000000000010010101000100000000001001
100010000000000010000010000000000010011001
100110111010101110000110111010101110011111
100000001000000000000000001000000000000101
100001000000000010010101000100000000001001
100010000000000010000010000000000010011001
100110111010101110000110111010101110011111
100000001000000000000000001000000000000101
100001000000000010010101000100000000001001
100010000000000010000010000000000010011001
100110111010101110000110111010101110011111
100000001000000000000000001000000000000101
100001000000000010010101000100000000001001
100010000000000010000010000000000010011001
100110111010101110000110111010101110011111
100000001000000000000000001000000000000101
100001000000000010010101000100000000001001
100010000000000010000010000000000010011001
100110111010101110000110111010101110011111
100000001000000000000000001000000000000101
100001000000000010010101000100000000001001
100010000000000010000010000000000010011001
100110111010101110000110111010101110011111
100000001000000000000000001000000000000101
111111111111111111111111111111111111111111
